1111111111111111111111111111111111
1                              1
1    c     e                   1
1                      e   E   1
1               t              1
1       1             1        1
1       1             1        1
1       1       x     1        1
1       1             1    t   1
1       1             1        1
1       1     E       1        1
1                              1
1     t          p             1
1       1             1        1
1       1             1        1
1                   c          1
1            c                 1
1                       E      1
1                              1
1     t        e        t      1
1                 2            1
1                         c    1
1                              1
1111111111111111111111111111111111